root	root	root	root
n_a	n/a	n/a	n/a
Phanerozoic	Phanerozoic	Phanerozoikum	顯生宙
Cenozoic	Cenozoic	Känozoikum	新生代
Quaternary	Quaternary	Quartär	第四紀
Holocene	Holocene	Holozän	全新世
Pleistocene	Pleistocene	Pleistozän	更新世
Late_Pleistocene	Late Pleistocene	Altpleistozän	晚更新期
Middle_Pleistocene	Middle Pleistocene	Mittelpleistozän	中更新期
Calabrian	Calabrian	Calabrium	卡拉布里亞階
Gelasian	Gelasian	Gelasium	格拉斯期
Neogene	Neogene	Neogen	新近紀
Pliocene	Pliocene	Pliozän	上新世
Piacenzian	Piacenzian	Piacenzium	皮亞琴期
Zanclean	Zanclean	Zancleum	贊克爾期
Miocene	Miocene	Miozän	中新世
Messinian	Messinian	Messinium	墨西拿期
Tortonian	Tortonian	Tortonium	托爾頓期
Serravallian	Serravallian	Serravallium	塞拉瓦爾期
Langhian	Langhian	Langhium	蘭蓋期
Burdigalian	Burdigalian	Burdigalium	波爾多期
Aquitanian	Aquitanian	Aquitanium	阿基坦期
Paleogene	Paleogene	Paläogen	古近紀
Oligocene	Oligocene	Oligozän	漸新世
Chattian	Chattian	Chattium	恰特期
Rupelian	Rupelian	Rupelium	魯培爾期
Eocene	Eocene	Eozän	始新世
Priabonian	Priabonian	Priabonium	普里阿邦期
Bartonian	Bartonian	Bartonium	巴爾頓期
Lutetian	Lutetian	Lutetium	盧台特期
Ypresian	Ypresian	Ypresium	伊普雷斯期
Paleocene	Paleocene	Paläozän	古新世
Thanetian	Thanetian	Thanetium	贊尼特期
Selandian	Selandian	Seelandium	塞蘭特期
Danian	Danian	Danium	達寧期
Mesozoic	Mesozoic	Mesozoikum	中生代
Cretaceous	Cretaceous	Kreide	白堊紀
Late_Cretaceous	Late Cretaceous	Oberkreide	晚白堊世
Maastrichtian	Maastrichtian	Maastrichtium	馬斯垂克期
Campanian	Campanian	Campanium	坎帕期
Santonian	Santonian	Santonium	桑托期
Coniacian	Coniacian	Coniacium	科尼亞克期
Turonian	Turonian	Turonium	土侖期
Cenomanian	Cenomanian	Cenomanium	森諾曼期
Early_Cretaceous	Early Cretaceous	Unterkreide	早白堊世
Albian	Albian	Albium	阿爾布期
Aptian	Aptian	Aptium	阿普第期
Barremian	Barremian	Barremium	巴列姆期
Hauterivian	Hauterivian	Hauterivium	豪特里維期
Valanginian	Valanginian	Valanginium	凡藍今期
Berriasian	Berriasian	Berriasium	貝里亞期
Jurassic	Jurassic	Jura	侏羅紀
Late_Jurassic	Late Jurassic	Oberjura	晚侏羅世
Tithonian	Tithonian	Tithonium	提通期
Kimmeridgian	Kimmeridgian	Kimmeridgium	啟莫里期
Oxfordian	Oxfordian	Oxfordium	牛津期
Middle_Jurassic	Middle Jurassic	Mitteljura	中侏羅世
Callovian	Callovian	Callovium	卡洛維期
Bathonian	Bathonian	Bathonium	巴通期
Bajocian	Bajocian	Bajocium	巴柔期
Aalenian	Aalenian	Aalenium	阿連期
Early_Jurassic	Early Jurassic	Unterjura	早侏羅世
Toarcian	Toarcian	Toarcium	托阿爾期
Pliensbachian	Pliensbachian	Pliensbachium	普連斯巴奇期
Sinemurian	Sinemurian	Sinemurium	錫內穆期
Hettangian	Hettangian	Hettangium	海塔其期
Triassic	Triassic	Trias	三疊紀
Late_Triassic	Late Triassic	Obertrias	晚三疊世
Rhaetian	Rhaetian	Rhaetium	瑞替期
Norian	Norian	Norium	諾利期
Carnian	Carnian	Karnium	卡尼期
Middle_Triassic	Middle Triassic	Mitteltrias	中三疊世
Ladinian	Ladinian	Ladinium	拉丁尼期
Anisian	Anisian	Anisium	安尼西期
Early_Triassic	Early Triassic	Untertrias	早三疊世
Olenekian	Olenekian	Olenekium	奧倫尼剋期
Induan	Induan	Indusium	印度期
Paleozoic	Paleozoic	Paläozoikum	古生代
Permian	Permian	Perm	二疊紀
Lopingian	Lopingian	Lopingium	樂平世
Changhsingian	Changhsingian	Changhsingium	長興期
Wuchiapingian	Wuchiapingian	Wuchiapingium	吳家坪期
Guadalupian	Guadalupian	Guadalupium	瓜德魯普世
Capitanian	Capitanian	Capitanium	卡匹敦階
Wordian	Wordian	Wordium	沃德期
Roadian	Roadian	Roadium	羅德期
Cisuralian	Cisuralian	Cisuralium	烏拉爾世
Kungurian	Kungurian	Kungurium	空谷爾期
Artinskian	Artinskian	Artinskium	阿爾丁斯剋期
Sakmarian	Sakmarian	Sakmarium	薩克馬爾期
Asselian	Asselian	Asselium	阿瑟爾期
Carboniferous	Carboniferous	Karbon	石炭紀
Pennsylvanian	Pennsylvanian	Pennsylvanium	賓夕法尼亞世
Gzhelian	Gzhelian	Gzhelium	格舍爾期
Kasimovian	Kasimovian	Kasimovium	卡西莫夫期
Moscovian	Moscovian	Moskovium	莫斯科期
Bashkirian	Bashkirian	Bashkirium	巴什基爾期
Mississippian	Mississippian	Mississippium	密西西比世
Serpukhovian	Serpukhovian	Serpukhovium	謝爾普霍夫期
Visean	Viséan	Viséum	維憲期
Tournaisian	Tournaisian	Tournaisium	圖爾奈期
Devonian	Devonian	Devon	泥盆紀
Late_Devonian	Late Devonian	Oberdevon	晚泥盆世
Famennian	Famennian	Famennium	法門期
Frasnian	Frasnian	Frasnium	弗拉斯期
Middle_Devonian	Middle Devonian	Mitteldevon	中泥盆世
Givetian	Givetian	Givetium	吉維特期
Eifelian	Eifelian	Eifelium	艾菲爾期
Early_Devonian	Early Devonian	Unterdevon	早泥盆世
Emsian	Emsian	Emsium	埃姆斯期
Pragian	Pragian	Pragium	布拉格期
Lochkovian	Lochkovian	Lochkovium	洛赫科夫期
Silurian	Silurian	Silur	志留紀
Pridoli	Pridoli	Pridolium	普里道利世
Ludlow	Ludlow	Ludlow	羅德洛世
Ludfordian	Ludfordian	Ludfordium	盧德福德期
Gorstian	Gorstian	Gorstium	戈斯特期
Wenlock	Wenlock	Wenlock	文洛克世
Homerian	Homerian	Homerium	侯默期
Sheinwoodian	Sheinwoodian	Sheinwoodium	申伍德期
Llandovery	Llandovery	Llandovery	蘭多維利世
Telychian	Telychian	Telychium	特列奇期
Aeronian	Aeronian	Aeronium	愛隆期
Rhuddanian	Rhuddanian	Rhuddanium	魯丹期
Ordovician	Ordovician	Ordovizium	奧陶紀
Late_Ordovician	Late Ordovician	Oberordovizium	晚奧陶世
Hirnantian	Hirnantian	Hirnantium	赫南特期
Katian	Katian	Katium	凱迪期
Sandbian	Sandbian	Sandbium	桑比期
Middle_Ordovician	Middle Ordovician	Mittelordovizium	中奧陶世
Darriwilian	Darriwilian	Darriwilium	達瑞威爾期
Dapingian	Dapingian	Dapingium	大坪期
Early_Ordovician	Early Ordovician	Unterordovizium	早奧陶世
Floian	Floian	Floium	弗洛期
Tremadocian	Tremadocian	Tremadocium	特馬豆剋期
Cambrian	Cambrian	Kambrium	寒武紀
Furongian	Furongian	Furongium	芙蓉世
Stage_10	Stage 10	10. Stufe	第十期
Jiangshanian	Jiangshanian	Jiangshanium	江山期
Paibian	Paibian	Paibium	排碧期
Series_3	Series 3	3. Serie	第三世
Guzhangian	Guzhangian	Guzhangium	古丈期
Drumian	Drumian	Drumium	鼓山期
Stage_5	Stage 5	5. Stufe	第五期
Series_2	Series 2	2. Serie	第二世
Stage_4	Stage 4	4. Stufe	第四期
Stage_3	Stage 3	3. Stufe	第三期
Terreneuvian	Terreneuvian	Terreneuvium	紐芬蘭世
Stage_2	Stage 2	2. Stufe	第二期
Fortunian	Fortunian	Fortunium	幸運期
Precambrian	Precambrian	Präkambrium	前寒武紀
Proterozoic	Proterozoic	Proterozoikum	元古宙
Neoproterozoic	Neoproterozoic	Neoproterozoikum	新元古代
Ediacaran	Ediacaran	Ediacarium	埃迪卡拉紀
Cryogenian	Cryogenian	Cryogenium	成冰紀
Tonian	Tonian	Tonium	拉伸紀
Mesoproterozoic	Mesoproterozoic	Mesoproterozoikum	中元古代
Stenian	Stenian	Stenium	狹帶紀
Ectasian	Ectasian	Ectasium	延展紀
Calymmian	Calymmian	Calymmium	蓋層紀
Paleoproterozoic	Paleoproterozoic	Paläoproterozoikum	古元古代
Statherian	Statherian	Statherium	固結紀
Orosirian	Orosirian	Orosirium	造山紀
Rhyacian	Rhyacian	Rhyacium	層侵紀
Siderian	Siderian	Siderium	成鐵紀
Archean	Archean	Archaikum	太古宙
Neoarchean	Neoarchean	Neoarchaikum	新太古代
Mesoarchean	Mesoarchean	Mesoarchaikum	中太古代
Paleoarchean	Paleoarchean	Paläoarchaikum	古太古代
Eoarchean	Eoarchean	Eoarchaikum	始太古代
Hadean	Hadean	Hadaikum	冥古宙
head_supereon	 	 	 
head_eon	Eonothem	Äonothem	宇
head_era	Erathem	Ärathem	界
head_period	System	System	系
head_epoch	Series	Serie	統
head_age	Stage	Stufe	階
